011111
10C001
100001
10CEP1
111111
