111111111111111111111111111111111111111111111111111111111111
100000000000000000000000000000000000000001000000000000000001
100000000000000000000000000000000000000000100000010000000001
100000000000000000000000000000000000000000010000010001110001
10001P100011100100000000000000000000000000001000010000000001
1001010100101001000000000000000000C0000000000110000E000001C1
100100010011100100000000000000C00000000000000011000000001001
100000000000000000000000000000000000000000000001111111110001
100000000000000000000000000000000000000000000000100000000001
100000000000000000000000000000000000000000000000010000000001
100000000000000000000000010100000000000000000000000000000001
100000000000000000000000000000000000000000000000000000000001
100000000000000000001000000000CCC000000000000000000010000001
100000000000000000000000000000C0C000000000000000000001000001
100000000000000000000000000000CCC0000000000000000000001CCCC1
10000000000000000000000000000000000001000000000000000001CC11
100000000000000000000000000010000000000000000000000000001CC1
1000000000000000000000000000000000000000000000000000000001C1
10000000000000000000000000000000000C000000000000000000000011
1000000C1CCC1CC1C00000000000000000000000C0000000000000000001
100000CCC1CC1C1CCC000000000000000000000000000000000000000001
100000CCCC1C11CCCC0000000000000000000000C0000000000000000001
1000001111111111110000000000000C0000000000000000000000000001
100000CCCCC111CCCC000000000000000000000000000000000000000001
100000CCCC1C1C1CCC0000000000000C0000000000000000000000000001
100000000000000000000000000000000000000000000000000000000001
100000000000000000000000000000000000000001100110000000000001
100000000000000000000000000000000000000000101010000000000001
100000000000000000000000000000000000000000010100000000000001
111111000000000000cccccccccccccc1111111111ccccccccccc1111111
111111111111111111111111111111111111111111111111111111111111
