11111111111111111111111111111111111111111111111111111111111111
10000000000000000000000000000000000000000100000000000000000001
10000000000000000000000000000000000000000010000001000000000001
10000000000000000000000000000000000000000001000001000111000001
1000000000C0C0C00C00C00000000000000000000000100001000000000001
100000000C0C0C0C0C0C00000000000P000000000000011000000000011001
10000000C0C0C0CCC0C00C0000000000000000000000001100000000100001
10000000C0C0CCCCCC0C0C0000000000000000000000000111111111000001
10000000000000CCC000000000000000000000000000000010000000000001
10000000000000CCC000000000000000000000000000000001000000000001
10000000000000CCC000000000000000000000000000000000000000000001
10000000000CCCCCCCCC000000000000000000000000000000000000000001
100000000000000000000000000000CCC00000000000000000001000000001
100000000000000000000000000000CEC00000000000000000000100000001
100000000000000000000000000000CCC0000000000000000000001CCCCCC1
10000000000000000000000000000000000000000000000000000001CC1CC1
100000000000000000000000000000000000000000000000000000001CCCC1
1000000000000000000000000000000000000000000000000000000001CCC1
10000000000000000000000000000000000000000000000000000000001CC1
1000000C1CCC1CC1C0000000000000000000000000000000000000000001C1
100000CCC1CC1C1CCC00000000000000000000000000000000000000000011
10000CCCCC1C11CCCCC0000000000000000000000000000000000000000001
10000111111111111110000000000000000000000000000000000000000001
10000CCCCCC111CCCCC0000000000000000000000000000000000000000001
100000CCCC1C1C1CCC00000000000000000000000000000000000000000001
1000000CC1CC1CC1C000000000000000000000000000000000000000000001
10000000000000000000000000000000000000000110011000000000000001
10000000000000000000000000000000000000000010101000000000000001
10000000000000000000000000000000000000000001010000000000000001
11111111111111111111111111111111111111111111111111111111111111
