111111111111111111111
100000000000000000001
100000000C00000000001
10000000C0C0000000001
100000010C01000000001
100000C0CEC0C00000001
100000010C01000000001
10000000C0C0000000001
100000000C00000000001
100000000000000000001
1000000000000000000P1
111111111111111111111
