11111111111111
1P1CCC1CC1CCC1
1C111CCC111C11
1CCC1CCC1CCCC1
11C1CC1C1CCC11
1CCC1E1CCCC111
1CCC1111C1CC11
1CC1CCC1C111C1
1CCCC1CCCCCCC1
11111111111111
