111111
1PCE1
1000000111
1011011
101
1111
