11111
10001
1P001
100E1
11111
