11111
10C01
1P001
1C101
11111
