1111111
1C100C1
100C001
1CC0111
11100E1
1C101C1
1000001
1111111
