11111
1C001
11111
10EP1
11111
