11111
1E001
11111
1PCC1
11111
