11111
1P0E1
1C001
1CPP1
11111
